X X X X X X X X X X X X X X X X X X X X X X X X X 
X RS W W W W W W W W W W R W W W W W W W W W W S X 
X W W W W W W W W W W W R W W W W W W W W W W S X 
X W W W W W W W W W W W R W W W W W W W W W W W X 
X W W W W W W W W W W W R W W W W W W W W W W W X 
X W W W W W W W W W W W R W W W W W W W W W W W X 
X W W W W W W W W W W W R W W W W W W W W W W W X 
X W W W W W W W W W W W R W W W W W W W W W W W X 
X W W W W W W W W W W W R W W W W W W W W W W W X 
X W W W W W W W W W W W R W W W W W W W W W W W X 
X W W W W W W W W W W W R W W W W W W W W W W W X 
X W W W W W W W W W W W W W W W W W W W W W W W X 
X W W W W W W W W W W W W W W W W W W W W W W W X 
X W W W W W W W W W W W W W W W W W W W W W W W X 
X RS W W W W W W W W W W W W W W W W W W W W W S X 
X RS W W W W W W W R W W W W W W W W W W W W W W X 
X W W W W W W W W R W W W W W W W W W W W W W S X 
X RS W W W W W W W R W W W W W W W W W W W W W S X 
X W W W W W W W W R W W W W W W W W W W W W W S X 
X W W W W W W W W R W W W W W W W W W W W W W W X 
X W W W W W W W W W W W W W W W W W W W W W W W X 
X RS W W W W W W W W W W W W W W W W W W W W W S X 
X W W W W W W W W W W W W W W W W W W W W W W W X 
X W W W W W W W W W W W W W W W W W W W W W W W X 
X W W W W W W W W W W W W W W W W W W W W W W W X 
X W W W W W W W W W W W R W W W W W W W W W W W X 
X W W W W W W W W W W W R W W W W W W W W W W W X 
X W W W W W W W W W W W R W W W W W W W W W W S X 
X W W W W W W W W W W W R W W W W W W W W W W W X 
X W W W W W W W W W W W R W W W W W W W W W W W X 
X W W W W W W W W W W W W W W W W W W W W W W S X 
X RS W W W W W W W W W W W W W W W W W W W W W W X 
X W W W W W W W W W W W W W W W W W W W W W W S X 
X RS W W W W W W W W W W W W W W W W W W W W W W X 
X RS W W W W W W W W W W W W W W W W W W W W W S X 
X W W W W W W W W W W W R W W W W W W W W W W W X 
X W W W W W W W W W W W R W W W W W W W W W W W X 
X RS W W W W W W W W W W R W W W W W W W W W W W X 
X W W W W W W W W W W W R W W W W W W W W W W W X 
X W W W W W W W W W W W R W W W W W W W W W W W X 
X W W W W W W W W W W W W W W W W W W W W W W S X 
X W W W W W W W W W W W W W W W W W W W W W W S X 
X W W W W W W W W W W W W W W W W W W W W W W W X 
X RS W W W W W W W W W W W W W W W W W W W W W S X 
X W W W W W W W W W W W W W W W W W W W W W W W X 
X RS W W W W W W W W R W W W W W W W W W W W W S X 
X W W W W W W W W W R W W W W W W W W W W W W W X 
X RS W W W W W W W W R W W W W W W W W W W W W S X 
X W W W W W W W W W R W W W W W W W W W W W W S X 
X W W W W W W W W W R W W W W W W W W W W W W S X 
X W W W W W W W W W W W W W W W W W W W CM CM W W X 
X W W W W W W W W W W W W W W W W W W CM CM CM EM W X 
X W W W W W W W W W W W W W W W W W W CM CM CM W W X 
X W W W W W W W W W W W W W W W W W W W CM CM W W X 
X W W W W W W W W W W W W W W W W W W W W W W S X 
X RS W W W W W W W W W W R W W W W W W W W W W W X 
X W W W W W W W W W W W R W W W W W W W W W W S X 
X RS W W W W W W W W W W R W W W W W W W W W W W X 
X W W W W W W W W W W W R W W W W W W W W W W W X 
X W W W W W W W W W W W R W W W W W W W W W W W X 
X W W W W W W W W W W W W W W W W W W W W W W W X 
X W W W W W W W W W W W W W W W W W W W W W W W X 
X W W W W W W W W W W W W W W W W W W W W W W W X 
X W W W W W W W W W W W W W W W W W W W W W W W X 
X W W W W W W W W W W W W W W W W W W W W W W W X 
X W W W W W W W W W W W W R W W W W W W W W W S X 
X RS W W W W W W W W W W W R W W W W W W W W W W X 
X RS W W W W W W W W W W W R W W W W W W W W W W X 
X W W W W W W W W W W W W R W W W W W W W W W W X 
X W W W W W W W W W W W W R W W W W W W W W W W X 
X W W W W W W W W W W W W W W W W W W W W W W S X 
X W W W W W W W W W W W W W W W W W W W W W W W X 
X RS W W W W W W W W W W W W W W W W W W W W W W X 
X RS W W W W W W W W W W W W W W W W W W W W W W X 
X RS W W W W W W W W W W W W W W W W W W W W W W X 
X RS W W W W W W W W R W W W W W W W W W W W W S X 
X W W W W W W W W W R W W W W W W W W W W W W W X 
X W W W W W W W W W R W W W W W W W W W W W W W X 
X W W W W W W W W W R W W W W W W W W W W W W W X 
X W W W W W W W W W R W W W W W W W W W W W W W X 
X W W W W W W W W W W W W W W W W W W W W W W S X 
X RS W W SI SI G W W W W W W W W W W W W W W W W S X 
X W W W SI W W W W W W W W W W W W W W W W W W W X 
X SI SI SI SI SI G W W W W W W W W W W W W W W W W S X 
X RS W W SI W W W W W W W W W W W W W W W W W W W X 
X W W W SI SI G W W W R W W W W W W W W W W W W W X 
X W W W W W W W W W R W W W W W W W W W W W W S X 
X W W W W W W W W W R W W W W W W W W W W W W W X 
X W W W W W W W W W R W W W W W W W W W W W W W X 
X W W W W W W W W W R W W W W W W W W W W W W W X 
X W W W W W W W W W W W W W W W W W W W W W W W X 
X W W W W W W W W W W W W W W W W W W W W W W W X 
X W W W W W W W W W W W W W W W W W W W W W W W X 
X W W W W W W W W W W W W W W W W W W W W W W S X 
X RS W W W W W W W W W W W W W W W W W W W W W W X 
X RS W W W W W W W W R W W W W W W W W W W W W W X 
X RS W W W W W W W W R W W W W W W W W W W W W W X 
X W W W W W W W W W R W W W W W W W W W W W W W X 
X RS W W W W W W W W R W W W W W W W W W W W W W X 
X W W W W W W W W W R W W W W W W W W W W W W W X 
X W W W W W W W W W W W W W W W W W W W W W W W X 
X W W W W W W W W W W W W W W W W W W W W W W W X 
X RS W W W W W W W W W W W W W W W W W W W W W W X 
X W W W W W W W W W W W W W W W W W W W W W W S X 
X RS W W W W W W W W W W W W W W W W W W W W W W X 
X W W W W W W W W W W W W W R W W W W W W W W W X 
X RS W W W W W W W W W W W W R W W W W W W W W W X 
X W W W W W W W W W W W W W R W W W W W W W W W X 
X RS W W W W W W W W W W W W R W W W W W W W W W X 
X W W W W W W W W W W W W W R W W W W W W W W S X 
X RS W W W W W W W W W W W W W W W W W W W W W W X 
X W W W W W W W W W W W W W W W W W W W W W W W X 
X W W W W W W W W W W W W W W W W W W W W W W W X 
X W W W W W W W W W W W W W W W W W W W W W W W X 
X RS W W W W W W W W W W W W W W W W W W W W W W X 
X W W W W W W W W W W W W R W W W W W W W W W S X 
X W W W W W W W W W W W W R W W W W W W W W W W X 
X W W W W W W W W W W W W R W W W W W W W W W W X 
X W W W W W W W W W W W W R W W W W W W W W W W X 
X W W W W W W W W W W W W R W W W W W W W W W S X 
X W W W W W W W W W W W W W W W W W W W W W W S X 
X W W W W W W W W W W W W W W W W W W W W W W W X 
X W W W W W W W W W W W W W W W W W W W W W W S X 
X RS W W W W W W W W W W W W W W W W W W W W W W X 
X W W W W W W W W W W W W W W W W W W W W W W W X 
X RS W W W W W W W W W W R W W W W W W W W W W S X 
X RS W W W W W W W W W W R W W W W W W W W W W W X 
X RS W W W W W W W W W W R W W W W W W W W W W S X 
X W W W W W W W W W W W R W W W W W W W W W W S X 
X W W W W W W W W W W W R W W W W W W W W W W S X 
X W W W W W W W W W W W W W W W W W W W W W W W X 
X W W W W W W W W W W W W W W W W W W W W W W W X 
X W W W W W W W W W W W W W W W W W W W W W W W X 
X RS W W W W W W W W W W W W W W W W W W W W W W X 
X W W W W W W W W W W W W W W W W W W W W W W W X 
X W W W W W W W W W W W W R W W W W W W W W W W X 
X W W W W W W W W W W W W R W W W W W W W W W W X 
X W W W W W W W W W W W W R W W W W W W W W W W X 
X W W W W W W W W W W W W R W W W W W W W W W W X 
X W W W W W W W W W W W W R W W W W W W W W W W X 
X W W W W W W W W W W W W W W W W W W W W W W W X 
X RS W W W W W W W W W W W W W W W W W W W W W W X 
X W W W W W W W W W W W W W W W W W W W W W W W X 
X W W W W W W W W W W W W W W W W W W W W W W W X 
X RS W W W W W W W W W W W W W W W W W W W W W W X 
X RS W W W W W W W W W W W W R W W W W W W W W W X 
X W W W W W W W W W W W W W R W W W W W CM CM W S X 
X W W W W W W W W W W W W W R W W W W CM CM CM EM W X 
X W W W W W W W W W W W W W R W W W W CM CM CM W W X 
X W W W W W W W W W W W W W R W W W W W CM CM W W X 
X W W W W W W W W W W W W W W W W W W W W W W S X 
X RS W W W W W W W W W W W W W W W W W W W W W W X 
X W W W W W W W W W W W W W W W W W W W W W W W X 
X RS W W W W W W W W W W W W W W W W W W W W W W X 
X W W W W W W W W W W W W W W W W W W W W W W S X 
X W W W W W W W W W W W R W W W W W W W W W W W X 
X W W W W W W W W W W W R W W W W W W W W W W S X 
X W W W W W W W W W W W R W W W W W W W W W W W X 
X W W W W W W W W W W W R W W W W W W W W W W W X 
X W W W W W W W W W W W R W W W W W W W W W W W X 
X W W W W W W W W W W W W W W W W W W W W W W W X 
X W W W W W W W W W W W W W W W W W W W W W W S X 
X RS W W W W W W W W W W W W W W W W W W W W W S X 
X RS W W W W W W W W W W W W W W W W W W W W W W X 
X W W W W W W W W W W W W W W W W W W W W W W W X 
X W W W W W W W W W R W W W W W W W W W W W W W X 
X W W W W W W W W W R W W W W W W W W W W W W W X 
X W W W W W W W W W R W W W W W W W W W W W W W X 
X W W W W W W W W W R W W W W W W W W W W W W W X 
X W W W W W W W W W R W W W W W W W W W W W W W X 
X RS W W W W W W W W W W W W W W W W W W W W W W X 
X W W W W W W W W W W W W W W W W W W W W W W W X 
X RS W W W W W W W W W W W W W W W W W W W W W W X 
X W W W W W W W W W W W W W W W W W W W W W W W X 
X W W W W W W W W W W W W W W W W W W W W W W W X 
X W W W W W W W W W W W W R W W W W W W W W W W X 
X W W W W W W W W W W W W R W W W W W W W W W W X 
X W W W W W W W W W W W W R W W W W W W W W W W X 
X W W W W W W W W W W W W R W W W W W W W W W W X 
X RS W W W W W W W W W W W R W W W W W W W W W W X 
X W W W W W W W W W W W W W W W W W W W W W W W X 
X W W W W W W W W W W W W W W W W W W W W W W W X 
X W W W W W W W W W W W W W W W W W W W W W W W X 
X W W W W W W W W W W W W W W W W W W W W W W W X 
X W W W W W W W W W W W W W W W W W W W W W W W X 
X RS W W SI SI G W W W W R W W W W W W W W W W W W X 
X W W W SI W W W W W W R W W W W W W W W W W W W X 
X SI SI SI SI SI G W W W W R W W W W W W W W W W W W X 
X W W W SI W W W W W W R W W W W W W W W W W W S X 
X W W W SI SI G W W W W R W W W W W W W W W W W S X 
X W W W W W W W W W W W W W W W W W W W W W W S X 
X W W W W W W W W W W W W W W W W W W W W W W W X 
X W W W W W W W W W W W W W W W W W W W W W W W X 
X W W W W W W W W W W W W W W W W W W W W W W W X 
X W W W W W W W W W W W W W W W W W W W W W W W X 
X W W W W W W W W W W W W R W W W W W W W W W S X 
X W W W W W W W W W W W W R W W W W W W W W W W X 
X W W W W W W W W W W W W R W W W W W W W W W S X 
X W W W W W W W W W W W W R W W W W W W W W W S X 
X W W W W W W W W W W W W R W W W W W W W W W W X 
X W W W W W W W W W W W W W W W W W W W W W W S X 
X W W W W W W W W W W W W W W W W W W W W W W W X 
X RS W W W W W W W W W W W W W W W W W W W W W W X 
X W W W W W W W W W W W W W W W W W W W W W W S X 
X W W W W W W W W W W W W W W W W W W W W W W W X 
X W W W W W W W W W R W W W W W W W W W W W W W X 
X W W W W W W W W W R W W W W W W W W W W W W S X 
X W W W W W W W W W R W W W W W W W W W W W W W X 
X W W W W W W W W W R W W W W W W W W W W W W W X 
X W W W W W W W W W R W W W W W W W W W W W W W X 
X W W W W W W W W W W W W W W W W W W W W W W W X 
X W W W W W W W W W W W W W W W W W W W W W W W X 
X W W W W W W W W W W W W W W W W W W W W W W W X 
X W W W W W W W W W W W W W W W W W W W W W W W X 
X RS W W W W W W W W W W W W W W W W W W W W W W X 
X W W W W W W W W R W W W W W W W W W W W W W W X 
X W W W W W W W W R W W W W W W W W W W W W W W X 
X RS W W W W W W W R W W W W W W W W W W W W W W X 
X RS W W W W W W W R W W W W W W W W W W W W W W X 
X W W W W W W W W R W W W W W W W W W W W W W W X 
X W W W W W W W W W W W W W W W W W W W W W W W X 
X W W W W W W W W W W W W W W W W W W W W W W W X 
X W W W W W W W W W W W W W W W W W W W W W W W X 
X W W W W W W W W W W W W W W W W W W W W W W W X 
X W W W W W W W W W W W W W W W W W W W W W W W X 
X W W W W W W W W W W W W W W R W W W W W W W W X 
X W W W W W W W W W W W W W W R W W W W W W W S X 
X W W W W W W W W W W W W W W R W W W W W W W W X 
X W W W W W W W W W W W W W W R W W W W W W W W X 
X RS W W W W W W W W W W W W W R W W W W W W W W X 
X W W W W W W W W W W W W W W W W W W W W W W W X 
X W W W W W W W W W W W W W W W W W W W W W W W X 
X W W W W W W W W W W W W W W W W W W W W W W S X 
X W W W W W W W W W W W W W W W W W W W W W W W X 
X RS W W W W W W W W W W W W W W W W W W W W W W X 
X W W W W W W W W W W W W W W R W W W W W W W S X 
X W W W W W W W W W W W W W W R W W W W W W W W X 
X W W W W W W W W W W W W W W R W W W W W W W W X 
X RS W W W W W W W W W W W W W R W W W W W W W S X 
X W W W W W W W W W W W W W W R W W W W W W W W X 
X W W W W W W W W W W W W W W W W W W W W W W W X 
X W W W W W W W W W W W W W W W W W W W W W W S X 
X W W W W W W W W W W W W W W W W W W W CM CM W W X 
X W W W W W W W W W W W W W W W W W W CM CM CM EM W X 
X W W W W W W W W W W W W W W W W W W CM CM CM W W X 
X W W W W W W W W W W W R W W W W W W W CM CM W W X 
X W W W W W W W W W W W R W W W W W W W W W W W X 
X W W W W W W W W W W W R W W W W W W W W W W W X 
X W W W W W W W W W W W R W W W W W W W W W W W X 
X W W W W W W W W W W W R W W W W W W W W W W W X 
X W W W W W W W W W W W W W W W W W W W W W W W X 
X RS W W W W W W W W W W W W W W W W W W W W W W X 
X W W W W W W W W W W W W W W W W W W W W W W W X 
X RS W W W W W W W W W W W W W W W W W W W W W S X 
X W W W W W W W W W W W W W W W W W W W W W W W X 
X W W W W W W W W W W W W R W W W W W W W W W S X 
X RS W W W W W W W W W W W R W W W W W W W W W W X 
X W W W W W W W W W W W W R W W W W W W W W W W X 
X W W W W W W W W W W W W R W W W W W W W W W S X 
X W W W W W W W W W W W W R W W W W W W W W W S X 
X W W W W W W W W W W W W W W W W W W W W W W W X 
X RS W W W W W W W W W W W W W W W W W W W W W W X 
X RS W W W W W W W W W W W W W W W W W W W W W W X 
X RS W W W W W W W W W W W W W W W W W W W W W W X 
X W W W W W W W W W W W W W W W W W W W W W W W X 
X W W W W W W W W W W W W W W R W W W W W W W W X 
X RS W W W W W W W W W W W W W R W W W W W W W S X 
X W W W W W W W W W W W W W W R W W W W W W W W X 
X W W W W W W W W W W W W W W R W W W W W W W S X 
X W W W W W W W W W W W W W W R W W W W W W W W X 
X W W W W W W W W W W W W W W W W W W W W W W S X 
X RS W W W W W W W W W W W W W W W W W W W W W W X 
X W W W W W W W W W W W W W W W W W W W W W W W X 
X W W W W W W W W W W W W W W W W W W W W W W W X 
X RS W W W W W W W W W W W W W W W W W W W W W W X 
X W W W W W W W W W W R W W W W W W W W W W W W X 
X W W W W W W W W W W R W W W W W W W W W W W W X 
X RS W W W W W W W W W R W W W W W W W W W W W S X 
X RS W W W W W W W W W R W W W W W W W W W W W S X 
X RS W W W W W W W W W R W W W W W W W W W W W W X 
X W W W W W W W W W W W W W W W W W W W W W W W X 
X W W W W W W W W W W W W W W W W W W W W W W W X 
X W W W W W W W W W W W W W W W W W W W W W W W X 
X W W W W W W W W W W W W W W W W W W W W W W S X 
X RS W W W W W W W W W W W W W W W W W W W W W W X 
X RS W W W W W W W R W W W W W W W W W W W W W W X 
X W W W W W W W W R W W W W W W W W W W W W W W X 
X W W W W W W W W R W W W W W W W W W W W W W W X 
X W W W W W W W W R W W W W W W W W W W W W W W X 
X W W W SI SI G W W R W W W W W W W W W W W W W S X 
X W W W SI W W W W W W W W W W W W W W W W W W W X 
X SI SI SI SI SI G W W W W W W W W W W W W W W W W W X 
X W W W SI W W W W W W W W W W W W W W W W W W W X 
X W W W SI SI G W W W W W W W W W W W W W W W W W X 
X W W W W W W W W W W W W W W W W W W W W W W W X 
X W W W W W W W W W W W W W W W W W W W W W W S X 
X W W W W W W W W W W W W W W W W W W W W W W S X 
X W W W W W W W W W W W W W W W W W W W W W W W X 
X RS W W W W W W W W W W W W W W W W W W W W W W X 
X X X X X X X X X X X X X X X X X X X X X X X X X 
