C C C C C C C C C C C C C C C C C C C C C C C C C 
C B B B B B B B B B B B C B B B B B B B B B B O C 
C O B B B B B B B B B B C B B B B B B B B B B O C 
C B B B B B B B B B B B C B B B B B B B B B B B C 
C B B B B B B B B B B B C B B B B B B B B B B B C 
C B B B B B B B B B B B C B B B B B B B B B B B C 
C O B B B B B B B B B B C B B B B B B B B B B B C 
C B B B B B B B B B B B C B B B B B B B B B B B C 
C B B B B B B B B B B B C B B B B B B B B B B O C 
C B B B B B B B B B B B C B B B B B B B B B B B C 
C O B B B B B B B B B B C B B B B B B B B B B O C 
C O B B B B B B B B B B B B B B B B B B B B B B C 
C O B B B B B B B B B B B B B B B B B B B B B O C 
C B B B B B B B B B B B B B B B B B B B B B B B C 
C B B B B B B B B B B B B B B B B B B B B B B O C 
C B B B B B B B B B B B B B B C B B B B B B B B C 
C B B B B B B B B B B B B B B C B B B B B B B B C 
C B B B B B B B B B B B B B B C B B B B B B B B C 
C B B B B B B B B B B B B B B C B B B B B B B B C 
C B B B B B B B B B B B B B B C B B B B B B B O C 
C B B B B B B B B B B B B B B B B B B B B B B B C 
C B B B B B B B B B B B B B B B B B B B B B B O C 
C B B B B B B B B B B B B B B B B B B B B B B B C 
C B B B B B B B B B B B B B B B B B B B B B B B C 
C B B B B B B B B B B B B B B B B B B B B B B B C 
C B B B B B B B B B B B B B C B B B B B B B B B C 
C B B B B B B B B B B B B B C B B B B B B B B B C 
C B B B B B B B B B B B B B C B B B B B B B B B C 
C B B B B B B B B B B B B B C B B B B B B B B B C 
C B B B B B B B B B B B B B C B B B B B B B B B C 
C B B B B B B B B B B B B B B B B B B B B B B B C 
C B B B B B B B B B B B B B B B B B B B B B B B C 
C B B B B B B B B B B B B B B B B B B B B B B O C 
C B B B B B B B B B B B B B B B B B B B B B B B C 
C B B B B B B B B B B B B B B B B B B B B B B B C 
C B B B B B B B B B B C B B B B B B B B B B B B C 
C B B B B B B B B B B C B B B B B B B B B B B B C 
C O B B B B B B B B B C B B B B B B B B B B B B C 
C B B B B B B B B B B C B B B B B B B B B B B B C 
C O B B B B B B B B B C B B B B B B B B B B B B C 
C O B B B B B B B B B B B B B B B B B B B B B O C 
C B B B B B B B B B B B B B B B B B B B B B B B C 
C B B B B B B B B B B B B B B B B B B B B B B B C 
C B B B B B B B B B B B B B B B B B B B B B B B C 
C B B B B B B B B B B B B B B B B B B B B B B B C 
C B B B B B B B B C B B B B B B B B B B B B B B C 
C B B B B B B B B C B B B B B B B B B B B B B B C 
C B B B B B B B B C B B B B B B B B B B B B B B C 
C O B B B B B B B C B B B B B B B B B B B B B B C 
C O B B B B B B B C B B B B B B B B B B B B B O C 
C B B B B B B B B B B B B B B B B B B B B B B O C 
C B B B B B B B B B B B B B B B B B B B B B B B C 
C O B B B B B B B B B B B B B B B B B B B B B B C 
C B B B B B B B B B B B B B B B B B B B B B B B C 
C B B B B B B B B B B B B B B B B B B B B B B B C 
C O B B B B B B B B B C B B B B B B B B B B B B C 
C B B B B B B B B B B C B B B B B B B B B B B B C 
C O B B B B B B B B B C B B B B B B B B B B B O C 
C B B B B B B B B B B C B B B B B B B B B B B B C 
C O B B B B B B B B B C B B B B B B B B B B B B C 
C B B B B B B B B B B B B B B B B B B B B B B B C 
C O B B B B B B B B B B B B B B B B B B B B B B C 
C O B B B B B B B B B B B B B B B B B B B B B O C 
C B B B B B B B B B B B B B B B B B B B B B B B C 
C O B B B B B B B B B B B B B B B B B B B B B B C 
C B B B B B B B B B B B B C B B B B B B B B B B C 
C B B B B B B B B B B B B C B B B B B B B B B B C 
C B B B B B B B B B B B B C B B B B B B B B B B C 
C B B B B B B B B B B B B C B B B B B B B B B B C 
C B B B B B B B B B B B B C B B B B B B B B B O C 
C B B B B B B B B B B B B B B B B B B B B B B O C 
C B B B B B B B B B B B B B B B B B B B B B B B C 
C B B B B B B B B B B B B B B B B B B B B B B O C 
C O B B B B B B B B B B B B B B B B B B B B B O C 
C O B B B B B B B B B B B B B B B B B B B B B O C 
C B B B B B B B B B B C B B B B B B B B B B B B C 
C O B B B B B B B B B C B B B B B B B B B B B B C 
C B B B B B B B B B B C B B B B B B B B B B B O C 
C O B B B B B B B B B C B B B B B B B B B B B B C 
C O B B B B B B B B B C B B B B B B B B B B B B C 
C O B B B B B B B B B B B B B B B B B B B B B O C 
C B B B B B B B B B B B B B B B B B B B B B B B C 
C B B B B B B B B B B B B B B B B B B B B B B B C 
C B B B B B B B B B B B B B B B B B B B B B B B C 
C B B B B B B B B B B B B B B B B B B B B B B B C 
C B B B B B B B B B B B B B B C B B B B B B B B C 
C B B B B B B B B B B B B B B C B B B B B B B B C 
C O B B B B B B B B B B B B B C B B B B B B B O C 
C B B B B B B B B B B B B B B C B B B B B B B B C 
C B B B B B B B B B B B B B B C B B B B B B B O C 
C B B B B B B B B B B B B B B B B B B B B B B B C 
C B B B B B B B B B B B B B B B B B B B B B B B C 
C O B B B B B B B B B B B B B B B B B B B B B O C 
C O B B B B B B B B B B B B B B B B B B B B B O C 
C O B B B B B B B B B B B B B B B B B B B B B O C 
C B B B B B B B B B B B C B B B B B B B B B B B C 
C B B B B B B B B B B B C B B B B B B B B B B B C 
C B B B B B B B B B B B C B B B B B B B B B B O C 
C B B B B B B B B B B B C B B B B B B B B B B O C 
C B B B B B B B B B B B C B B B B B B B B B B B C 
C B B B B B B B B B B B B B B B B B B B B B B O C 
C B B B B B B B B B B B B B B B B B B B B B B B C 
C B B B B B B B B B B B B B B B B B B B B B B O C 
C B B B B B B B B B B B B B B B B B B B B B B B C 
C B B B B B B B B B B B B B B B B B B B B B B B C 
C B B B B B B B B B B B B B C B B B B B B B B O C 
C B B B B B B B B B B B B B C B B B B B B B B B C 
C B B B B B B B B B B B B B C B B B B B B B B B C 
C B B B B B B B B B B B B B C B B B B B B B B B C 
C B B B B B B B B B B B B B C B B B B B B B B B C 
C B B B B B B B B B B B B B B B B B B B B B B B C 
C B B B B B B B B B B B B B B B B B B B B B B O C 
C B B B B B B B B B B B B B B B B B B B B B B O C 
C O B B B B B B B B B B B B B B B B B B B B B B C 
C B B B B B B B B B B B B B B B B B B B B B B B C 
C B B B B B B B B B B B B C B B B B B B B B B B C 
C B B B B B B B B B B B B C B B B B B B B B B O C 
C O B B B B B B B B B B B C B B B B B B B B B O C 
C B B B B B B B B B B B B C B B B B B B B B B B C 
C B B B B B B B B B B B B C B B B B B B B B B B C 
C B B B B B B B B B B B B B B B B B B B B B B O C 
C B B B B B B B B B B B B B B B B B B B B B B B C 
C B B B B B B B B B B B B B B B B B B B B B B B C 
C O B B B B B B B B B B B B B B B B B B B B B B C 
C O B B B B B B B B B B B B B B B B B B B B B O C 
C B B B B B B B B B B B C B B B B B B B B B B B C 
C B B B B B B B B B B B C B B B B B B B B B B B C 
C B B B B B B B B B B B C B B B B B B B B B B O C 
C B B B B B B B B B B B C B B B B B B B B B B B C 
C B B B B B B B B B B B C B B B B B B B B B B B C 
C B B B B B B B B B B B B B B B B B B B B B B B C 
C B B B B B B B B B B B B B B B B B B B B B B O C 
C B B B B B B B B B B B B B B B B B B B B B B B C 
C B B B B B B B B B B B B B B B B B B B B B B B C 
C B B B B B B B B B B B B B B B B B B B B B B B C 
C B B B B B B B B C B B B B B B B B B B B B B B C 
C B B B B B B B B C B B B B B B B B B B B B B B C 
C B B B B B B B B C B B B B B B B B B B B B B B C 
C B B B B B B B B C B B B B B B B B B B B B B O C 
C B B B B B B B B C B B B B B B B B B B B B B B C 
C B B B B B B B B B B B B B B B B B B B B B B B C 
C B B B B B B B B B B B B B B B B B B B B B B B C 
C B B B B B B B B B B B B B B B B B B B B B B B C 
C B B B B B B B B B B B B B B B B B B B B B B B C 
C B B B B B B B B B B B B B B B B B B B B B B O C 
C B B B B B B B B B B B B C B B B B B B B B B O C 
C B B B B B B B B B B B B C B B B B B B B B B B C 
C O B B B B B B B B B B B C B B B B B B B B B B C 
C B B B B B B B B B B B B C B B B B B B B B B O C 
C B B B B B B B B B B B B C B B B B B B B B B O C 
C O B B B B B B B B B B B B B B B B B B B B B B C 
C B B B B B B B B B B B B B B B B B B B B B B B C 
C B B B B B B B B B B B B B B B B B B B B B B B C 
C B B B B B B B B B B B B B B B B B B B B B B B C 
C B B B B B B B B B B B B B B B B B B B B B B O C 
C O B B B B B B B B B C B B B B B B B B B B B B C 
C O B B B B B B B B B C B B B B B B B B B B B B C 
C B B B B B B B B B B C B B B B B B B B B B B B C 
C B B B B B B B B B B C B B B B B B B B B B B B C 
C B B B B B B B B B B C B B B B B B B B B B B B C 
C B B B B B B B B B B B B B B B B B B B B B B B C 
C B B B B B B B B B B B B B B B B B B B B B B O C 
C B B B B B B B B B B B B B B B B B B B B B B B C 
C O B B B B B B B B B B B B B B B B B B B B B B C 
C B B B B B B B B B B B B B B B B B B B B B B B C 
C B B B B B B B B B B B B B B C B B B B B B B O C 
C B B B B B B B B B B B B B B C B B B B B B B B C 
C B B B B B B B B B B B B B B C B B B B B B B O C 
C B B B B B B B B B B B B B B C B B B B B B B O C 
C B B B B B B B B B B B B B B C B B B B B B B B C 
C O B B B B B B B B B B B B B B B B B B B B B B C 
C O B B B B B B B B B B B B B B B B B B B B B B C 
C B B B B B B B B B B B B B B B B B B B B B B B C 
C B B B B B B B B B B B B B B B B B B B B B B B C 
C O B B B B B B B B B B B B B B B B B B B B B O C 
C B B B B B B B B B B B B B B C B B B B B B B B C 
C B B B B B B B B B B B B B B C B B B B B B B B C 
C B B B B B B B B B B B B B B C B B B B B B B B C 
C B B B B B B B B B B B B B B C B B B B B B B B C 
C B B B B B B B B B B B B B B C B B B B B B B B C 
C B B B B B B B B B B B B B B B B B B B B B B B C 
C B B B B B B B B B B B B B B B B B B B B B B O C 
C B B B B B B B B B B B B B B B B B B B B B B O C 
C O B B B B B B B B B B B B B B B B B B B B B B C 
C B B B B B B B B B B B B B B B B B B B B B B O C 
C B B B B B B B B B B B B B C B B B B B B B B O C 
C B B B B B B B B B B B B B C B B B B B B B B B C 
C B B B B B B B B B B B B B C B B B B B B B B B C 
C O B B B B B B B B B B B B C B B B B B B B B B C 
C O B B B B B B B B B B B B C B B B B B B B B B C 
C B B B B B B B B B B B B B B B B B B B B B B B C 
C O B B B B B B B B B B B B B B B B B B B B B O C 
C B B B B B B B B B B B B B B B B B B B B B B O C 
C B B B B B B B B B B B B B B B B B B B B B B O C 
C B B B B B B B B B B B B B B B B B B B B B B B C 
C O B B B B B B B B B B B B C B B B B B B B B B C 
C B B B B B B B B B B B B B C B B B B B B B B B C 
C O B B B B B B B B B B B B C B B B B B B B B B C 
C B B B B B B B B B B B B B C B B B B B B B B B C 
C B B B B B B B B B B B B B C B B B B B B B B O C 
C B B B B B B B B B B B B B B B B B B B B B B B C 
C B B B B B B B B B B B B B B B B B B B B B B B C 
C B B B B B B B B B B B B B B B B B B B B B B B C 
C B B B B B B B B B B B B B B B B B B B B B B O C 
C O B B B B B B B B B B B B B B B B B B B B B B C 
C B B B B B B B B B B B B C B B B B B B B B B B C 
C B B B B B B B B B B B B C B B B B B B B B B O C 
C B B B B B B B B B B B B C B B B B B B B B B B C 
C B B B B B B B B B B B B C B B B B B B B B B B C 
C B B B B B B B B B B B B C B B B B B B B B B B C 
C B B B B B B B B B B B B B B B B B B B B B B B C 
C B B B B B B B B B B B B B B B B B B B B B B O C 
C B B B B B B B B B B B B B B B B B B B B B B B C 
C O B B B B B B B B B B B B B B B B B B B B B B C 
C B B B B B B B B B B B B B B B B B B B B B B B C 
C O B B B B B B B B B B B C B B B B B B B B B B C 
C O B B B B B B B B B B B C B B B B B B B B B B C 
C B B B B B B B B B B B B C B B B B B B B B B B C 
C B B B B B B B B B B B B C B B B B B B B B B B C 
C O B B B B B B B B B B B C B B B B B B B B B O C 
C B B B B B B B B B B B B B B B B B B B B B B B C 
C B B B B B B B B B B B B B B B B B B B B B B B C 
C B B B B B B B B B B B B B B B B B B B B B B B C 
C B B B B B B B B B B B B B B B B B B B B B B O C 
C B B B B B B B B B B B B B B B B B B B B B B B C 
C B B B B B B B B C B B B B B B B B B B B B B B C 
C B B B B B B B B C B B B B B B B B B B B B B O C 
C B B B B B B B B C B B B B B B B B B B B B B O C 
C B B B B B B B B C B B B B B B B B B B B B B B C 
C B B B B B B B B C B B B B B B B B B B B B B O C 
C B B B B B B B B B B B B B B B B B B B B B B B C 
C B B B B B B B B B B B B B B B B B B B B B B B C 
C O B B B B B B B B B B B B B B B B B B B B B B C 
C O B B B B B B B B B B B B B B B B B B B B B B C 
C B B B B B B B B B B B B B B B B B B B B B B O C 
C B B B B B B B B B B B B C B B B B B B B B B B C 
C B B B B B B B B B B B B C B B B B B B B B B B C 
C B B B B B B B B B B B B C B B B B B B B B B O C 
C O B B B B B B B B B B B C B B B B B B B B B B C 
C B B B B B B B B B B B B C B B B B B B B B B B C 
C B B B B B B B B B B B B B B B B B B B B B B B C 
C O B B B B B B B B B B B B B B B B B B B B B B C 
C B B B B B B B B B B B B B B B B B B B B B B O C 
C B B B B B B B B B B B B B B B B B B B B B B B C 
C B B B B B B B B B B B B B B B B B B B B B B O C 
C B B B B B B B B B B B B B C B B B B B B B B O C 
C B B B B B B B B B B B B B C B B B B B B B B B C 
C B B B B B B B B B B B B B C B B B B B B B B B C 
C B B B B B B B B B B B B B C B B B B B B B B B C 
C B B B B B B B B B B B B B C B B B B B B B B B C 
C O B B B B B B B B B B B B B B B B B B B B B O C 
C B B B B B B B B B B B B B B B B B B B B B B B C 
C O B B B B B B B B B B B B B B B B B B B B B B C 
C B B B B B B B B B B B B B B B B B B B B B B B C 
C O B B B B B B B B B B B B B B B B B B B B B B C 
C B B B B B B B B B B B B B B C B B B B B B B B C 
C B B B B B B B B B B B B B B C B B B B B B B B C 
C B B B B B B B B B B B B B B C B B B B B B B B C 
C B B B B B B B B B B B B B B C B B B B B B B O C 
C B B B B B B B B B B B B B B C B B B B B B B B C 
C B B B B B B B B B B B B B B B B B B B B B B B C 
C O B B B B B B B B B B B B B B B B B B B B B B C 
C B B B B B B B B B B B B B B B B B B B B B B B C 
C B B B B B B B B B B B B B B B B B B B B B B B C 
C O B B B B B B B B B B B B B B B B B B B B B B C 
C B B B B B B B B C B B B B B B B B B B B B B B C 
C B B B B B B B B C B B B B B B B B B B B B B B C 
C O B B B B B B B C B B B B B B B B B B B B B B C 
C O B B B B B B B C B B B B B B B B B B B B B B C 
C B B B B B B B B C B B B B B B B B B B B B B B C 
C B B B B B B B B B B B B B B B B B B B B B B B C 
C B B B B B B B B B B B B B B B B B B B B B B B C 
C O B B B B B B B B B B B B B B B B B B B B B B C 
C B B B B B B B B B B B B B B B B B B B B B B B C 
C B B B B B B B B B B B B B B B B B B B B B B B C 
C B B B B B B B B B B B B B B C B B B B B B B O C 
C B B B B B B B B B B B B B B C B B B B B B B B C 
C B B B B B B B B B B B B B B C B B B B B B B B C 
C B B B B B B B B B B B B B B C B B B B B B B O C 
C B B B B B B B B B B B B B B C B B B B B B B B C 
C B B B B B B B B B B B B B B B B B B B B B B B C 
C B B B B B B B B B B B B B B B B B B B B B B B C 
C B B B B B B B B B B B B B B B B B B B B B B B C 
C O B B B B B B B B B B B B B B B B B B B B B B C 
C B B B B B B B B B B B B B B B B B B B B B B B C 
C B B B B B B B B B B B C B B B B B B B B B B B C 
C B B B B B B B B B B B C B B B B B B B B B B O C 
C B B B B B B B B B B B C B B B B B B B B B B B C 
C B B B B B B B B B B B C B B B B B B B B B B B C 
C B B B B B B B B B B B C B B B B B B B B B B B C 
C B B B B B B B B B B B B B B B B B B B B B B B C 
C B B B B B B B B B B B B B B B B B B B B B B B C 
C B B B B B B B B B B B B B B B B B B B B B B B C 
C B B B B B B B B B B B B B B B B B B B B B B O C 
C O B B B B B B B B B B B B B B B B B B B B B B C 
C B B B B B B B B B B B B B B B B B B B B B B B C 
C B B B B B B B B B B B B B B B B B B B B B B O C 
C B B B B B B B B B B B B B B B B B B B B B B O C 
C O B B B B B B B B B B B B B B B B B B B B B B C 
C C C C C C C C C C C C C C C C C C C C C C C C C 
